




 6 3 2 7
14 2 2 6
15 2 2 6
16 5 2 7
17 2 2 6
18 2 2 6
