




14 2 1 6
15 2 1 6
16 5 1 6
17 2 1 6
18 2 1 6
