




 6   3 3 7
 7   5 3 8
 8 100 3 9
14   2 3 6
15   2 3 6
16   5 3 8
17   2 3 6
18   2 3 6
